Alx3	RRNRTTFSTFQLEELEKVFQKTHYPDVYAREQLALRTDLTEARVQVWFQNRRAKWRK
Vsx1	RRHRTVFTAHQLEELEKAFGEAHYPDVYAREMLAAKTELPEDRIQVWFQNRRAKWRK
Prop1	RRHRTTFNPAQLEQLESAFGRNQYPDIWAREGLAQDTGLSEARIQVWFQNRRAKQRK
Prrx1	RRNRTTFNSSQLQALERVFERTHYPDAFVREDLARRVNLTEARVQVWFQNRRAKFRR
Prrx2	RRNRTTFNSSQLQALERVFERTHYPDAFVREELARRVNLSEARVQVWFQNRRAKFRR
Rax	RRNRTTFTTYQLHELERAFEKSHYPDVYSREELAGKVNLPEVRVQVWFQNRRAKWRR
Rhox11	PRKAYRFTPGQLWELQAVFVENQYPDALKRKELAGLLNVDEQKIKDWFNNKRAKYRK
Rhox6	RYRRTRFTHSQLHDLERLFQETRYPSLRARRDLARWMGVDECDVQNWFRMRRALFQR
Shox2	RRSRTNFTLEQLNELERLFDETHYPDAFMREELSQRLGLSEARVQVWFQNRRAKCRK
Six1	ETSYCFKEKSRGVLREWYAHNPYPSPREKRELAEATGLTTTQVSNWFKNRRQRDRA
Six2	ETSYCFKEKSRSVLREWYAHNPYPSPREKRELAEATGLTTTQVSNWFKNRRQRDRA
Six3	EQKTHCFKERTRSLLREWYLQDPYPNPSKKRELAQATGLTPTQVGNWFKNRRQRDRA
Six4	GEETVYCFKEKSRNALKELYKQNRYPSPAEKRHLAKITGLSLTQVSNWFKNRRQRDRN
Six6	EQKTHCFKERTRHLLREWYLQDPYPNPSKKRELAQATGLTPTQVGNWFKNRRQRDRA
Tcf1	RRNRFKWGPASQQILFQAYERQKSPSKEERETLVEECNRAECIQRGVSPSQAQGLGSNLVTEVRVYNWFANRRKEEAF
Tcf2	RRNRFKWGPASQQILYQAYDRQKNPSKEEREALVEECNRAECLQRGVSPSKAHGLGSNLVTEVRVYNWFANRRKEEAF
Tgif1	RRRRGNLPKESVQILRDWLYEHRYNAYPSEQEKALLSQQTHLSTLQVCNWFINARRRLLP
Tgif2	RKRRGNLPKESVKILRDWLYLHRYNAYPSEQEKLSLSGQTNLSVLQICNWFINARRRLLP
Titf1	RKRRVLFSQAQVYELERRFKQQKYLSAPEREHLASMIHLTPTQVKIWFQNHRYKMKR
Tlx2	KKPRTSFSRSQVLELERRFLRQKYLASAERAALAKALRMTDAQVKTWFQNRRTKWRR
Uncx4.1	RRTRTNFTGWQLEELEKAFNESHYPDVFMREALALRLDLVESRVQVWFQNRRAKWRK
Vax1	KRTRTSFTAEQLYRLEMEFQRCQYVVGRERTELARQLNLSETQVKVWFQNRRTKQKK
Vax2	KRTRTSFTAEQLYRLEMEFQRCQYVVGRERTELARQLNLSETQVKVWFQNRRTKQKK